**************D*****
****  2     2   ****
****** **** ********
****** **** ********
*   3         2 ****
****** **** ***** **
****** **** **** 1**
****** **** **** ***
* 5   5       1   **
** ******* ***** ***
** ******* ***** ***
**   4****    ** ***
** ******* ***** ***
** *******  **** ***
**  4      ***** ***
****** ****** ** ***
****** **     ** ***
**     3 2   1   ***
********************
********************
